1 1 1 1 1 1 1 1 1 1 1 1 1 1 1  
1 4 2 2 5 2 2 2 2 2 5 2 2 4 1 	 
1 3 1 1 3 1 1 1 1 1 3 1 1 3 1 	 
1 3 1 6 8 2 2 2 2 2 8 6 1 3 1 	 
1 3 1 3 1 1 1 0 1 1 1 3 1 3 1 	 
11 7 2 9 1 1 0 0 0 1 1 10 2 7 11
1 1 1 1 1 1 1 1 1 1 1 1 1 1 1
1 1 1 1 1 1 1 1 1 1 1 1 1 1 1
